#########################
#@           #####      #
# #####      #          #
# #    #     #   C   ####
# # C     %  #          #
# #######     C  #####  #
#           ####        #
##### ######## #  X     #
#                 ##### #
#  #######  #####       #
#          ###### %     #
#  CCC     ######       #
#  CCC    ###############
#  CCC    # %     &CCCC##
#########################

