#########################
#      C  C    #      X #
#   %    CC    #        #
#              #        #
#     ###      ##       #
#     ####     ####     #
#        ##       ###   #
#         #####         #
#         #C@C#   %     #
###  ####### ############
#          C            #
#  CCC     C   CC C     #
#  CCC     ##### ########
#  CCC   %         CCC &#
#########################

