#########################
#@   ###       ###      #
### #   #######   # ### #
# C     #       #       #
# ##### ### ### ####### #
#     %     #     C     #
##### ####### ### #######
#     #       & #       #
### ### ####### #########
#  %#   #           #   #
# ##### ### ### ###### ##
#     #       #       X #
### ### ### ### #########
#           %    C      #
#########################
