#########################
#@      #######       C #
# ######       #######  #
# #    #########        #
# # ####       #######  #
# # #     ####       # %#
# # ### ######### #######
#   C   #       #   #   #
####### ##### ##### ### #
#     &     %           #
##### ##### ##### #######
#       #         #     #
######### ####### ##### #
#      %         C     X#
#########################
