#########################
#@         %        #####
### ##### ####### ###   #
# C   #   #     #       #
####### ##### ##### #####
#       #   C       %   #
##### ########### #######
#       #       #   #####
# ### ####### ### ###   #
# C #     &     #       #
### ### ######### ##### #
#       #         #     #
################# #######
#####%      C         X #
#########################
