#########################
#@    ###       ###     #
### ##   #####   ## ### #
#   ##     #     ##     #
# ### ##### ##### ##### #
#   %       #       C   #
##### ### ####### ### ###
#   #   #         #   # #
# ### ### ####### ### ### 
#   C       %       C   #
### ### ####### ### ##### 
#   #   #         #     #
# ### ##### ### ##### ### 
#         &   X         #
#########################
