#########################
#@    ###       ###     #
# ### # # ##### # # ### #
# #   # # #   # # # #   #
# # ### ### % ### ### ###
# #   C       C        ##
# ####### ###############
#         #         &   #
######### # #############
#    X    #            ##
######### ########## ####
#      %           C    #
# ####### ####### ### ###
#         #####   %     #
#########################

