#########################
#       ###     %       #
### ### #   ### ### ### #
#   #   #       #       #
# ##### ##### ######### #
#   %       C   #       #
##### ########### #######
#     #     #   C   #   #
# ### ## ## ####### ##### 
# #       #      &#     #
# ########### ### ##### #
#       %         #     #
##### ########### #####@#
#   C       X        ####
#########################
