#########################
#@   ##        %    #####
### ### #####3#####    ##
#   #   #   #     ###   #
# ### ### ##### #####   #
#   #   # C     #   #   #
### ######### ##### ### #
#   %     &     #     # #
####### ############### #
#     #   #         #   #
# ### ##### ##### ### ###
# #       #     #   C   #
# ########### ### ##### #
#      C  %        X    #
#########################
